046;046;046;6;0;0;0;0;0;0;0;0;0;0;0;0;0;0;0;0;0
046;046;046;6;0;0;0;0;0;0;0;0;0;0;0;0;0;0;0;0;0
046;044;046;6;0;0;0;0;0;0;0;0;0;0;0;0;0;0;0;0;0
046;046;046;5;7;0;0;0;0;0;0;0;0;0;0;0;0;0;0;0;0
046;046;046;046;5;1;1;7;0;0;0;0;0;0;0;0;0;0;0;0;0
046;046;046;046;046;046;046;6;0;0;0;0;0;0;0;0;0;4;1;1;1
046;046;046;60;8;8;8;15;0;0;0;0;0;4;1;1;1;2;046;046;046
046;046;60;15;0;0;0;0;0;0;0;0;0;3;046;046;046;046;046;046;046
46;046;6;0;0;0;0;0;0;0;0;0;4;2;046;046;044;046;046;046;046
46;046;6;0;0;0;0;0;4;1;1;1;2;046;046;046;046;046;046;046;046
46;046;6;0;0;0;4;1;2;046;046;046;046;046;046;046;046;046;046;045;046
0;0;0;0;0;0;0;0;0;0;0;0;0;0;0;0;0;0;0;0;0
0;0;0;0;0;0;0;0;0;0;0;0;0;0;0;0;0;0;0;0;0
0;0;0;0;0;0;0;0;0;0;0;0;0;0;0;0;0;0;0;0;0
0;0;0;0;0;0;0;0;0;0;0;0;0;0;0;0;0;0;0;0;0
0;0;0;0;0;0;0;0;0;0;0;0;0;0;0;0;0;0;0;0;0
0;0;0;0;0;0;0;0;0;0;0;0;0;0;0;0;0;0;0;0;0
0;0;0;0;0;0;0;0;0;0;0;0;0;0;0;0;0;0;0;0;0
0;0;0;0;0;0;0;0;0;0;0;0;0;0;0;0;0;0;0;0;0
0;0;0;0;0;0;0;0;0;0;0;0;0;0;0;0;0;0;0;0;0
0;0;0;0;0;0;0;0;0;0;0;0;0;0;0;0;0;0;0;0;0
0;0;0;0;0;0;0;0;0;0;0;0;0;0;0;0;0;0;0;0;0
0;0;0;0;0;0;0;0;0;0;0;0;0;0;0;0;0;0;0;0;0
0;0;0;0;0;0;0;0;0;0;0;0;0;0;0;0;0;0;0;0;0
0;0;0;0;0;0;0;0;0;0;0;0;0;0;0;0;0;0;0;0;0
0;0;0;0;0;0;0;0;0;0;0;0;0;0;0;0;0;0;0;0;0
0;0;0;0;0;0;0;0;0;0;0;0;0;0;0;0;0;0;0;0;0
0;0;0;0;0;0;0;0;0;0;0;0;0;0;0;0;0;0;0;0;0
0;0;0;0;0;0;0;0;0;0;0;0;0;0;0;0;0;0;0;0;0
0;0;0;46;46;46;46;46;46;0;0;0;0;0;0;0;0;0;0;0;0
46;046;42;46;46;46;46;46;46;046;0;0;046;046;046;046;046;046;046;046;046
46;046;46;46;46;46;46;46;46;046;046;046;046;046;046;046;046;046;046;046;046
46;046;46;46;46;44;46;46;46;046;046;046;046;046;046;046;046;045;046;046;046
0;0;0;0;0;0;0;0;0;0;0;0;0;0;0;0;0;0;0;0;0
0;0;0;0;0;0;0;0;0;0;0;0;0;0;0;0;0;0;0;0;0
0;0;0;0;0;0;0;0;0;0;0;0;0;0;0;0;0;0;0;0;0
0;0;0;0;0;0;0;0;0;0;0;0;0;0;0;0;0;0;0;0;0
0;0;0;0;0;0;0;0;0;0;0;0;0;0;0;0;0;0;0;0;0
0;0;0;0;0;0;0;0;0;0;0;0;0;0;0;0;0;0;0;0;0
0;0;0;0;0;0;0;0;0;0;0;0;0;0;0;0;0;0;0;0;0
0;0;0;0;0;0;0;0;0;0;0;0;0;0;0;0;0;0;0;0;0
0;0;0;0;0;0;0;0;0;0;0;0;0;0;0;0;0;0;0;0;0
0;0;0;0;0;0;0;0;0;0;0;0;0;0;0;0;0;0;0;0;0
0;0;0;25;24;27;0;0;0;0;0;0;0;0;0;0;0;0;0;0;0