0;0;0;0;0;0;0;0;0;0;0;0;0;0;3;46;46;46;46;46;46
0;0;0;0;0;0;0;0;0;0;0;0;0;4;2;46;46;40;46;46;46
0;0;0;0;0;0;0;0;0;0;0;0;0;3;46;46;46;46;46;46;46
0;0;0;0;0;0;0;0;0;0;0;0;0;14;8;8;8;59;46;46;46
0;0;0;0;0;0;0;0;0;0;0;0;0;0;0;0;0;14;8;8;8
0;0;0;0;0;0;0;0;0;0;0;0;0;0;0;0;0;0;0;0;0
0;0;0;0;0;0;0;0;0;0;0;0;0;0;0;0;0;0;0;0;0
0;0;0;0;0;0;0;0;0;0;0;0;0;4;1;1;1;7;0;0;0
0;0;0;0;0;0;0;0;0;0;0;4;1;2;46;46;5;1;1;1;1
0;0;0;0;0;0;0;0;0;0;4;2;46;46;46;46;46;46;46;44;46
0;0;0;0;0;0;0;0;0;0;3;46;46;42;46;46;46;46;46;46;46
0;0;0;0;0;0;0;0;0;0;0;0;0;0;0;0;0;0;0;0;0
0;0;0;0;0;0;0;0;0;0;0;0;0;0;0;0;0;0;0;0;0
0;0;0;0;0;0;0;0;0;0;0;0;0;0;0;0;0;0;0;0;0
0;0;0;0;0;0;0;0;0;0;0;0;0;0;0;0;0;0;0;0;0
0;0;0;0;0;0;0;0;0;0;0;0;0;0;0;0;0;0;0;0;0
0;0;0;0;0;0;0;0;0;0;0;0;0;0;0;0;0;0;50;0;0
0;0;0;0;0;0;0;0;0;0;0;0;0;0;48;0;0;0;0;0;0
0;0;0;0;0;0;0;0;0;0;0;0;0;0;0;0;0;0;0;0;0
0;0;0;0;0;0;0;0;0;0;0;0;0;0;0;0;0;0;0;0;0
0;0;0;0;0;0;0;0;0;0;0;0;0;0;0;0;0;0;0;0;0
0;0;0;0;0;0;0;0;0;0;0;0;0;0;0;0;0;0;0;0;0
0;0;0;0;0;0;0;0;0;0;0;0;0;0;0;0;0;0;0;0;0
0;0;0;0;0;0;0;0;0;0;0;0;0;0;46;46;46;46;46;46;46
0;0;0;0;0;0;0;0;0;0;0;0;0;0;46;46;46;46;46;46;46
0;0;0;0;0;0;0;0;0;0;0;0;0;0;46;46;46;46;46;46;46
0;0;0;0;0;0;0;0;0;0;0;0;0;0;46;46;46;46;0;46;46
0;0;0;0;0;0;0;0;0;0;0;0;0;0;46;46;46;46;46;46;46
0;0;0;0;0;0;0;0;0;0;0;0;0;46;46;46;46;46;39;46;46
0;0;0;0;0;0;0;0;0;0;0;0;0;0;46;46;46;46;46;46;46
0;0;0;0;0;0;0;0;0;0;0;0;0;0;0;0;0;0;0;0;0
0;0;0;0;0;0;0;0;0;0;0;0;0;0;0;0;0;0;0;0;0
0;0;0;0;0;0;0;0;0;0;0;0;0;0;0;0;0;0;0;0;0
0;0;0;0;0;0;0;0;0;0;0;0;0;0;0;0;0;0;0;0;0
0;0;0;0;0;0;0;0;0;0;0;0;0;0;0;0;0;0;0;0;0
0;0;0;0;0;0;0;0;0;0;0;0;0;0;0;0;0;0;0;0;0
0;0;0;0;0;0;0;0;0;0;0;0;27;0;0;0;0;0;0;0;0
0;0;0;0;0;0;0;0;0;0;0;0;0;0;0;0;0;0;0;0;0
0;0;0;0;0;0;0;0;0;0;0;0;0;0;0;0;0;0;0;0;0
0;0;0;0;0;0;0;0;0;0;0;0;0;0;0;0;0;0;0;0;0
0;0;0;0;0;0;0;0;0;0;0;0;0;0;0;0;0;0;0;0;0
0;0;0;0;0;0;0;0;0;0;0;0;0;0;0;0;0;0;0;0;0
0;0;0;0;0;0;0;0;0;0;0;0;0;0;0;0;0;0;0;0;0
0;0;0;0;0;0;0;0;24;27;0;0;0;0;0;0;0;0;0;0;0