0;0;0;0;0;0;0;0;0;0;0;0;0;0;0;0;0;0;0;0;0
0;0;0;0;0;61;29;29;29;29;29;29;62;0;0;0;0;0;0;0;0
0;0;0;61;29;31;0;0;0;0;0;0;35;29;62;0;0;0;0;0;0
0;0;61;31;0;0;0;0;0;0;0;0;0;0;35;62;0;0;0;0;0
0;0;32;0;0;0;0;0;0;0;0;0;0;0;0;36;0;0;0;0;0
0;0;32;0;0;0;0;0;0;0;0;0;0;0;0;35;29;29;29;29;62
0;0;32;0;0;0;0;0;0;0;0;0;0;0;0;0;0;0;0;0;35
0;0;33;34;0;0;0;65;0;0;0;0;0;0;0;0;0;0;0;0;0
0;0;0;33;30;30;30;30;30;30;30;30;30;30;30;34;0;0;0;0;0
0;0;0;0;0;0;0;0;0;0;0;0;0;0;0;33;30;30;30;30;30
0;0;0;0;0;0;0;0;0;0;0;0;0;0;0;0;0;0;0;0;0
0;0;0;0;0;0;0;0;0;0;0;0;0;0;0;0;0;0;0;0;0
0;0;0;0;0;0;0;0;0;0;0;0;0;0;0;0;0;0;0;0;0
0;0;0;0;0;0;0;0;0;0;0;0;0;0;0;0;0;0;0;0;0
0;0;0;0;0;0;0;0;0;0;0;0;0;0;0;0;0;0;0;0;0
0;0;0;0;0;0;0;0;0;0;0;0;0;0;0;0;0;0;0;0;0
0;0;0;0;0;0;0;0;0;0;0;0;0;0;0;0;0;0;0;0;0
0;0;0;0;0;0;0;0;0;0;0;0;0;0;0;0;0;0;0;0;0
0;0;0;0;0;0;0;0;0;0;0;0;0;0;0;0;0;0;0;0;0
0;0;0;0;0;0;0;0;0;0;0;0;0;0;0;0;0;0;0;0;0
0;0;0;0;0;0;0;0;0;0;0;0;0;0;0;0;0;0;0;0;0
0;0;0;0;0;0;0;0;0;0;0;0;0;0;0;0;0;0;0;0;0
46;46;46;46;46;46;46;46;46;46;46;46;46;46;46;46;46;46;46;46;46
46;46;46;46;46;46;46;46;46;46;46;46;46;46;46;46;46;46;46;46;46
46;46;46;46;44;46;46;46;46;46;46;46;46;46;46;46;46;46;46;46;46
46;46;46;46;46;46;46;46;46;46;46;46;46;46;46;46;42;46;46;46;46
46;46;46;46;46;46;46;46;46;46;46;46;46;46;46;46;46;46;46;46;46
46;46;46;46;46;46;46;46;46;46;46;46;46;46;46;46;46;46;46;46;46
46;46;46;46;46;46;46;46;46;45;46;46;46;46;46;46;46;46;46;46;46
46;41;46;46;46;46;46;46;46;46;46;46;46;46;46;46;46;46;46;46;46
46;46;46;46;46;46;46;46;46;46;46;46;46;46;46;46;46;46;46;46;46
46;46;46;46;46;46;46;46;46;46;46;46;46;40;46;46;46;46;46;46;46
46;46;46;46;46;46;46;46;46;46;46;46;46;46;46;46;46;46;46;46;46