0;0;0;0;0;0;0;0;0;0;0;0;0;0;0;0;0;0;0;0;0
0;0;0;0;0;0;0;0;0;0;0;0;0;0;0;0;0;0;0;0;0
34;0;0;0;0;0;0;0;0;0;0;0;0;0;0;0;0;4;1;1;1
32;0;0;0;0;0;0;0;0;0;0;4;1;1;1;1;1;2;46;46;46
32;0;0;0;0;0;0;0;0;0;0;14;59;46;46;46;46;46;46;46;46
31;0;0;0;0;0;0;0;0;0;0;0;14;8;8;59;46;46;46;46;46
63;0;0;0;0;0;0;0;0;0;0;0;0;0;57;3;46;46;46;46;46
30;30;30;30;30;30;30;30;30;30;34;58;58;0;4;2;46;46;46;46;46
46;46;46;46;46;46;46;46;46;46;32;0;0;0;14;8;8;8;8;8;8
46;46;46;46;46;46;46;46;46;46;32;0;0;0;0;0;0;0;0;0;0
46;46;46;46;46;46;46;46;46;46;32;0;0;0;0;0;0;0;0;0;0
0;0;0;0;0;0;0;0;0;0;0;0;0;0;0;0;0;0;0;0;0
0;0;0;0;0;0;0;0;0;0;0;0;0;0;0;0;0;0;0;0;0
0;0;0;0;0;0;0;0;0;0;0;0;0;0;0;0;0;0;0;0;0
0;0;0;0;0;0;0;0;0;0;0;0;0;0;0;0;0;0;0;0;0
0;0;0;0;0;0;0;0;0;0;0;0;0;0;0;0;0;0;0;0;0
0;0;0;0;0;0;0;0;0;0;0;0;0;0;0;0;0;0;0;0;0
0;0;0;0;0;0;0;47;0;0;0;0;0;0;0;0;0;0;0;0;0
0;0;0;0;0;0;0;0;0;0;0;0;0;0;0;0;0;0;0;0;0
0;0;0;0;0;0;0;0;0;0;0;0;0;0;0;0;0;0;0;0;0
0;0;0;0;0;0;0;0;0;0;0;0;0;0;0;0;0;0;0;0;0
0;0;0;0;0;0;0;0;0;0;0;0;0;0;0;0;0;0;0;0;0
0;0;0;0;0;0;0;0;0;0;0;0;0;0;0;0;0;0;0;0;0
0;0;0;0;0;0;0;0;0;0;0;0;0;0;0;0;0;0;0;0;0
0;0;0;0;0;0;0;0;0;0;0;0;0;0;0;0;0;0;0;0;0
0;0;0;0;0;0;0;0;0;0;51;0;0;0;0;0;0;0;0;0;0
0;0;0;0;0;0;0;0;0;0;0;0;0;0;0;0;0;0;0;0;0
46;0;0;0;0;0;0;0;0;0;0;0;0;0;0;0;0;0;0;0;0
46;0;0;0;0;0;0;0;0;0;0;0;0;0;0;0;0;0;0;0;0
0;0;0;0;0;0;0;0;0;0;0;46;46;46;46;46;46;46;46;46;0
0;0;0;0;0;0;0;0;0;0;0;46;46;46;46;46;46;46;0;0;0
0;0;0;0;0;0;0;0;0;0;0;46;46;46;46;46;46;0;0;0;0
0;0;0;0;0;0;0;0;0;0;0;46;46;46;46;0;0;0;0;0